Consonants

ب پ ت ج چ خ د ر ز ژ س ش غ ف ق ك گ ڭ ل م ن ھ ۋ ي
b p t j q h d r z zh s sh gh f q k g ng l m n h w y 
b p t dʒ tʃ χ,x d r,ɾ z ʒ s ʃ ʁ,ɣ f,ɸ q k ɡ ŋ l m n h,ɦ y,ʏ w,v j



Vowels

ا ە و ۇ ۆ ۈ ې ىي
a e o u ö ü é i
ɑ,a ɛ,æ o,ɔ u,ʊ ø y,ʏ e i,ɨ


from Wikipedia

Old Perso-Arabic alphabet (Kona Yëziq) used before the 20th century 	Modern Uyghur Arabic alphabet 	Latin 	Meaning
پيچاق 	پىچاق 	pichaq 	knife
يوسف 	يۈسۈپ 	Yüsüp 	Yusuf
ينگي حصار 	يېڭىسار 	Yëngisar 	Yangi Hissar
منافق 	مۇناپىق 	munapiq 	hypocrite
مسلمان 	مۇسۇلمان 	musulman 	Muslim
مارالباشي 	مارالبېشى 	Maralbëshi 	Maralbexi County
لونگي 	لۇنگى 	Lun'gi 	Lungi
كوندوز 	كۈندۈز 	kündüz 	day-time
كافر 	كاپىر 	kapir 	infidel
كاشقر 	قەشقەر 	Qeshqer 	Kashgar
قيرغيز 	قىرغىز 	Qirghiz 	Kirghiz
سلطان 	سۇلتان 	sultan 	sultan
ساريق قول 	سارىقول 	Sariqol 	Sarikol
ساريغ or ساريق 	سېرىق 	sériq 	yellow
دين 	دىن 	din 	religion
دولان 	دولان 	Dolan 	Dolan people
خلق 	خەلق 	xelq 	people
ختن 	خوتەن 	Xoten 	Khotan
حسن 	ھەسەن 	Hesen 	Hassan
بغرا 	بۇغرا 	bughra 	bull camel
اسلام 	ئىسلام 	Islam 	Islam
ارسلان 	ئارىسلان 	arislan 	lion
آلتی شهر 	ئالتە شەھەر 	Alte sheher 	Altishahr
آفاق خواجه 	ئاپاق خوجا 	Apaq Xoja 	Afaq Khoja